[
  [11, 11, 11, 11, 11, 11, 11, 11, 11, 11, 11, 11, 11, 11, 11, 11],
  [11, 0, 0, 12, 13, 0, 0, 0, 0, 0, 0, 0, 0, 0, 0, 11],
  [11, 0, 0, 0, 0, 0, 0, 0, 0, 0, 0, 0, 12, 13, 0, 11],
  [11, 0, 0, 0, 0, 0, 0, 0, 0, 0, 0, 0, 0, 0, 0, 11],
  [11, 0, 0, 0, 0, 0, 0, 0, 0, 12, 13, 0, 0, 0, 0, 11],
  [11, 0, 0, 0, 0, 0, 0, 0, 0, 0, 0, 0, 0, 0, 0, 11],
  [11, 0, 0, 0, 0, 0, 0, 0, 0, 0, 0, 0, 0, 9, 0, 11],
  [2, 2, 2, 2, 2, 3, 0, 0, 0, 0, 0, 4, 2, 2, 2, 2],
  [1, 1, 1, 1, 5, 0, 0, 0, 0, 0, 0, 0, 6, 1, 1, 1],
  [1, 1, 1, 8, 0, 0, 0, 0, 0, 0, 0, 0, 0, 6, 1, 1],
  [1, 1, 1, 9, 0, 0, 4, 2, 2, 2, 3, 0, 0, 0, 6, 1],
  [1, 1, 1, 9, 0, 0, 0, 6, 1, 5, 0, 0, 0, 0, 0, 7],
  [1, 1, 1, 10, 0, 0, 0, 0, 0, 0, 0, 0, 0, 0, 0, 7],
  [1, 1, 1, 2, 3, 0, 0, 0, 0, 0, 0, 0, 0, 10, 19, 1],
  [1, 1, 1, 8, 0, 0, 0, 0, 0, 4, 2, 2, 2, 2, 2, 1],
  [1, 1, 1, 8, 0, 0, 0, 0, 10, 0, 6, 1, 1, 1, 1, 1],
  [1, 1, 1, 8, 0, 0, 0, 0, 10, 0, 0, 6, 1, 1, 1, 1],
  [1, 1, 1, 8, 0, 4, 2, 2, 3, 0, 0, 0, 6, 1, 1, 1],
  [1, 1, 1, 5, 0, 0, 6, 5, 0, 0, 12, 13, 0, 6, 1, 1],
  [1, 1, 5, 0, 0, 0, 0, 0, 0, 0, 0, 0, 0, 0, 6, 1],
  [1, 8, 0, 0, 0, 0, 0, 0, 0, 0, 0, 0, 0, 0, 0, 7],
  [1, 8, 0, 0, 0, 0, 0, 0, 0, 0, 0, 0, 0, 0, 9, 1],
  [1, 8, 0, 0, 0, 0, 0, 10, 4, 2, 2, 2, 3, 0, 9, 1],
  [1, 9, 0, 0, 0, 0, 0, 10, 0, 6, 1, 5, 10, 0, 0, 7],
  [1, 10, 10, 0, 0, 0, 0, 0, 0, 0, 0, 0, 0, 10, 0, 7],
  [1, 2, 3, 0, 0, 0, 0, 0, 0, 0, 0, 0, 0, 0, 10, 1],
  [1, 1, 2, 2, 2, 2, 3, 0, 0, 0, 0, 9, 0, 0, 0, 7],
  [1, 1, 1, 1, 1, 5, 0, 0, 0, 4, 2, 2, 2, 2, 2, 1],
  [1, 1, 1, 9, 10, 0, 0, 0, 0, 0, 6, 1, 1, 1, 1, 1],
  [1, 1, 1, 10, 0, 0, 12, 13, 0, 0, 0, 6, 1, 1, 1, 1],
  [1, 1, 5, 0, 10, 0, 0, 0, 0, 0, 0, 0, 6, 1, 1, 1],
  [1, 5, 10, 0, 10, 0, 0, 0, 0, 0, 0, 0, 0, 6, 1, 1],
  [8, 0, 10, 9, 0, 10, 10, 0, 0, 0, 0, 0, 0, 0, 7, 1],
  [8, 0, 10, 0, 0, 0, 10, 0, 0, 0, 0, 0, 0, 0, 7, 1],
  [8, 0, 9, 0, 0, 0, 9, 9, 4, 2, 2, 3, 0, 0, 7, 1],
  [8, 0, 10, 0, 0, 0, 9, 0, 0, 6, 5, 0, 0, 0, 7, 1],
  [8, 0, 4, 2, 2, 2, 3, 0, 0, 0, 0, 0, 0, 0, 9, 1],
  [8, 0, 0, 0, 0, 0, 0, 0, 0, 0, 0, 0, 0, 10, 10, 1],
  [8, 0, 0, 0, 0, 0, 0, 0, 4, 2, 2, 2, 2, 2, 2, 1],
  [8, 10, 10, 10, 10, 0, 0, 0, 0, 6, 1, 1, 1, 1, 1, 1],
  [1, 9, 0, 0, 10, 0, 0, 0, 0, 0, 6, 1, 1, 1, 1, 1],
  [1, 18, 0, 0, 10, 0, 0, 0, 0, 0, 0, 6, 1, 1, 1, 1],
  [1, 9, 0, 0, 10, 0, 0, 0, 12, 13, 0, 0, 0, 0, 6, 1],
  [1, 2, 2, 2, 2, 2, 2, 3, 0, 0, 0, 0, 0, 0, 10, 1],
  [1, 1, 1, 1, 1, 5, 0, 0, 0, 0, 0, 0, 0, 10, 0, 7],
  [1, 1, 1, 1, 5, 0, 0, 0, 0, 0, 0, 0, 10, 0, 0, 7],
  [1, 1, 1, 1, 0, 0, 0, 0, 4, 2, 2, 2, 3, 0, 0, 7],
  [1, 1, 1, 5, 0, 0, 0, 0, 0, 6, 1, 5, 0, 0, 0, 7],
  [1, 5, 0, 0, 0, 0, 0, 0, 0, 0, 0, 0, 0, 0, 0, 7],
  [8, 0, 0, 0, 0, 0, 0, 0, 0, 0, 0, 0, 0, 0, 0, 7],
  [8, 0, 0, 0, 0, 0, 0, 0, 0, 0, 0, 0, 0, 0, 0, 7],
  [8, 0, 0, 4, 2, 2, 2, 17, 2, 2, 2, 2, 2, 3, 0, 7],
  [8, 0, 0, 0, 6, 1, 1, 1, 1, 1, 1, 1, 5, 0, 9, 1],
  [8, 0, 0, 0, 0, 6, 1, 1, 1, 1, 1, 5, 0, 0, 9, 1],
  [8, 0, 0, 0, 0, 0, 0, 0, 0, 0, 0, 0, 0, 0, 0, 7],
  [1, 10, 10, 9, 0, 0, 0, 0, 0, 0, 0, 0, 0, 0, 0, 7],
  [8, 0, 0, 0, 10, 0, 0, 0, 0, 0, 4, 2, 2, 2, 2, 1],
  [8, 0, 0, 0, 10, 0, 0, 0, 0, 0, 0, 6, 1, 1, 1, 1],
  [1, 2, 2, 2, 2, 2, 3, 0, 0, 12, 13, 0, 0, 6, 1, 1],
  [1, 1, 1, 1, 1, 5, 0, 0, 0, 0, 0, 0, 0, 0, 6, 1],
  [1, 1, 1, 1, 5, 0, 0, 0, 0, 0, 0, 0, 0, 0, 0, 7],
  [1, 1, 1, 5, 0, 0, 12, 13, 0, 0, 0, 0, 0, 0, 10, 1],
  [1, 9, 10, 0, 0, 0, 0, 0, 0, 0, 0, 0, 0, 10, 0, 7],
  [1, 10, 10, 0, 0, 0, 0, 0, 0, 0, 0, 0, 0, 0, 0, 7],
  [1, 2, 3, 0, 0, 0, 0, 0, 0, 0, 0, 0, 9, 9, 9, 1],
  [1, 5, 0, 0, 0, 0, 0, 0, 0, 0, 0, 0, 10, 0, 0, 7],
  [8, 0, 0, 0, 0, 0, 0, 0, 0, 0, 0, 0, 10, 0, 10, 1],
  [8, 0, 0, 4, 2, 2, 2, 2, 2, 2, 2, 2, 2, 2, 2, 1],
  [8, 0, 0, 0, 6, 1, 1, 1, 1, 1, 1, 1, 1, 1, 1, 1],
  [8, 0, 0, 0, 0, 0, 6, 1, 1, 1, 1, 1, 1, 1, 1, 1],
  [1, 2, 3, 0, 0, 0, 0, 0, 0, 9, 6, 1, 1, 1, 1, 1],
  [1, 5, 0, 0, 12, 13, 0, 0, 0, 0, 0, 0, 0, 6, 1, 1],
  [1, 9, 0, 0, 0, 0, 0, 0, 0, 0, 0, 0, 0, 0, 6, 1],
  [8, 0, 0, 0, 0, 0, 0, 4, 2, 2, 3, 0, 0, 0, 0, 7],
  [8, 0, 0, 0, 0, 0, 0, 0, 0, 0, 0, 0, 0, 0, 0, 7],
  [8, 0, 4, 2, 2, 3, 0, 0, 0, 0, 0, 0, 0, 0, 0, 7],
  [8, 0, 0, 0, 0, 0, 0, 0, 0, 0, 0, 0, 9, 0, 0, 7],
  [8, 0, 0, 0, 0, 0, 0, 0, 12, 13, 0, 4, 3, 0, 0, 7],
  [8, 0, 15, 0, 0, 0, 0, 0, 0, 0, 0, 0, 0, 0, 0, 7],
  [8, 0, 15, 0, 0, 0, 0, 0, 0, 0, 0, 0, 0, 0, 9, 1],
  [1, 3, 0, 0, 0, 0, 0, 0, 0, 0, 0, 0, 0, 0, 0, 7],
  [8, 0, 0, 0, 0, 4, 2, 3, 0, 0, 0, 0, 0, 0, 0, 7],
  [8, 0, 12, 13, 0, 0, 0, 0, 0, 0, 0, 4, 3, 0, 0, 7],
  [8, 0, 0, 0, 0, 0, 0, 0, 0, 0, 0, 0, 0, 0, 4, 1],
  [8, 0, 0, 0, 0, 0, 0, 0, 0, 0, 0, 0, 0, 0, 0, 7],
  [8, 0, 0, 0, 0, 0, 0, 0, 0, 0, 0, 0, 0, 0, 0, 7],
  [8, 0, 4, 2, 3, 0, 4, 2, 3, 0, 4, 2, 3, 0, 4, 1],
  [8, 0, 0, 0, 0, 0, 0, 0, 0, 0, 0, 0, 0, 0, 0, 7],
  [8, 0, 0, 0, 10, 15, 0, 4, 3, 0, 9, 0, 10, 15, 0, 7],
  [8, 0, 0, 0, 10, 15, 0, 0, 0, 0, 10, 0, 10, 15, 0, 7],
  [8, 0, 0, 0, 10, 0, 4, 2, 3, 0, 9, 0, 10, 0, 0, 7],
  [8, 0, 0, 0, 10, 0, 0, 0, 0, 0, 10, 0, 10, 0, 0, 7],
  [1, 2, 3, 0, 4, 2, 3, 0, 4, 2, 3, 0, 4, 2, 2, 1],
  [1, 5, 0, 0, 0, 0, 0, 0, 0, 0, 0, 0, 0, 6, 1, 1],
  [8, 0, 0, 0, 0, 0, 0, 0, 0, 0, 0, 0, 0, 0, 6, 1],
  [8, 0, 0, 0, 0, 0, 0, 0, 0, 0, 0, 0, 0, 0, 0, 7],
  [8, 0, 0, 15, 0, 0, 0, 0, 0, 12, 13, 0, 0, 0, 0, 7],
  [8, 0, 0, 15, 0, 0, 0, 0, 0, 0, 0, 0, 0, 0, 0, 7],
  [8, 0, 0, 15, 0, 0, 0, 0, 0, 0, 0, 0, 0, 0, 0, 7],
  [8, 0, 0, 12, 13, 0, 0, 0, 0, 0, 0, 0, 0, 0, 0, 7],
  [8, 0, 0, 0, 0, 0, 0, 0, 0, 0, 0, 0, 0, 0, 0, 7],
  [8, 0, 0, 0, 0, 0, 0, 0, 0, 0, 12, 13, 0, 0, 0, 7],
  [8, 0, 0, 0, 0, 0, 0, 0, 0, 0, 0, 0, 0, 0, 0, 7],
  [8, 0, 0, 0, 0, 0, 0, 0, 0, 0, 0, 0, 0, 0, 0, 7],
  [8, 0, 0, 0, 0, 0, 0, 0, 0, 0, 0, 0, 15, 0, 0, 7],
  [8, 0, 0, 0, 0, 0, 0, 0, 0, 0, 0, 0, 0, 0, 0, 7],
  [8, 0, 12, 13, 0, 15, 0, 0, 0, 0, 0, 0, 0, 0, 0, 7],
  [8, 0, 0, 0, 0, 0, 0, 0, 0, 0, 0, 0, 0, 0, 0, 7],
  [8, 0, 0, 0, 0, 0, 0, 0, 0, 0, 0, 0, 0, 0, 0, 6],
  [1, 22, 22, 22, 22, 22, 22, 22, 22, 22, 22, 22, 22, 22, 22, 22,22,22,22,22,22,22,22,22,22,22,22,22,22,22,22,22,22,22,22,22,22,22,22,22,22,22,22,22,22,22,22,28],
  [1, 25, 25, 25, 25, 25, 25, 25, 25, 25, 25, 25, 25, 25, 25, 25,25,2,2,2,2,2,2,25,25,25,31,28,25,25,25,25,25,29,28,28,28,30,25,25,25,25,25,25,25,25,28,28],
  [1, 25, 25, 25, 25, 25, 25, 25, 25, 25, 25, 25, 25, 25, 25, 25,25,28,28,28,28,28,28,25,25,25,25,28,25,25,25,25,25,28,25,25,25,35,25,25,25,25,25,25,25,28,28,28],
  [1, 2, 2, 2, 2, 30, 25, 25, 25, 25, 25, 25, 25, 25, 25, 25,25,31,28,28,28,28,32,25,25,25,25,28,25,25,25,25,25,28,25,25,25,35,25,25,25,25,25,25,25,35,35,28],
  [1, 28, 28, 28, 28, 28, 25, 25, 25, 25, 25, 25, 25, 25, 25, 25,25,25,25,25,25,9,25,25,25,25,25,28,28,30,25,25,25,28,25,25,25,35,25,25,25,25,25,25,25,35,9,28],
  [1, 18, 25, 25, 28, 28, 25, 25, 25,25, 25, 25, 25, 25, 25, 25,25,35,25,25,25,25,35,25,25,25,25,25,25,25,25,25,25,28,25,25,25,35,25,25,25,25,25,25,35,35,9,28],
  [1, 9, 25, 25, 25, 28, 25, 25, 25, 25, 25, 25, 25, 25, 25, 25,25,2,2,2,2,2,2,25,25,25,25,28,28,32,25,25,25,25,25,25,25,35,25,25,25,29,28,30,25,25,19,28],
  [1, 28, 25, 25, 25, 28, 25, 25, 25, 25, 25, 25, 25, 25, 25, 25,25,1,1,1,1,1,1,25,25,25,25,25,25,25,25,25,25,35,25,25,25,35,25,25,25,28,35,35,25,25,35,28],
  [1, 28, 30, 25, 25, 28, 25, 25, 25, 25, 25, 25, 25, 25, 25, 25,2,1,1,1,1,1,1,25,25,25,25,25,25,25,25,25,25,35,25,25,25,28,25,25,25,28,35,35,25,25,35,28],
  [1, 28, 28, 25, 25, 35, 25, 25, 25, 25, 25, 9, 9, 25, 25, 25,1,1,1,1,1,1,1,25,25,25,25,28,25,25,25,25,25,28,25,25,25,31,28,28,28,28,9,35,25,25,35,28],
  [1, 2, 2, 2, 2, 2, 2, 2, 2, 2, 2, 2, 2, 2, 2, 2,1,1,1,1,1,1,1,2,2,2,2,2,2,2,2,2,2,2,2,2,2,2,2,2,2,2,2,2,2,2,2,2],
  [1, 1, 1, 1, 1, 1, 1, 1, 1, 1, 1, 1, 1, 1, 1, 1,1,1,1,1,1,1,1,1,1,1,1,1,1,1,1,1,1,1,1,1,1,1,1,1,1,1,1,1,1,1,1,1],
  [1, 1, 1, 1, 1, 1, 1, 1, 1, 1, 1, 1, 1, 1, 1, 1,1,1,1,1,1,1,1,1,1,1,1,1,1,1,1,1,1,1,1,1,1,1,1,1,1,1,1,1,1,1,1,1],
  [1, 1, 1, 1, 1, 1, 1, 1, 1, 1, 1, 1, 1, 1, 1, 1,1,1,1,1,1,1,1,1,1,1,1,1,1,1,1,1,1,1,1,1,1,1,1,1,1,1,1,1,1,1,1,1],
  [1, 1, 1, 1, 1, 1, 1, 1, 1, 1, 1, 1, 1, 1, 1, 1,1,1,1,1,1,1,1,1,1,1,1,1,1,1,1,1,1,1,1,1,1,1,1,1,1,1,1,1,1,1,1]
]